11111111111111111111111111
10001000000000000000000001
10000000000000000000000001
10000111111111111111111111
10P001EC000000000000C00001
11111111111111111111111111